XXXXXXXXXXXXXXXXXXXXXXXXXXXXXXXXXXXXXXXXXXXXXXXXXXXXXXXXXXXXXXXXXXXXXXXXXXXXXXXXXXXXXXXXXXXXXXXXXXXXXXXXXXXXXXXXXXXXXXXXXXXXXXXXX
P     X         X       X     X           X     X       X               X     X                     X               X X     X   X
X XXX X XXXXXXX X XXX X X XXX X XXX XXXXX XXXXX X X XXX X X XXXXXXXXXXX XXX X X XXX XXXXXXXXXXXXXXX XXXXXXXXXXX XXX X X XXX X X X
X   X X     X   X X   X X X X   X X     X       X X X   X X       X   X     X X X X       X       X           X   X X     X X X X
XXXXX XXXXX X XXX X XXX X X XXXXX XXXXX XXX XXXXX X XXXXX XXXXX X X X XXXXXXX X X XXXXXXX XXXXXXX XXXXXXXXXXX XXX X XXXXX X X X X
X       X   X   X X   X X X       X   X X X X     X       X   X X X X     X   X X     X   X     X X         X X   X     X X   X X
X XXXXXXX XXXXX X XXX XXX XXXXXXX X X X X X X XXXXXXXXXXXXX X XXX X XXX XXX XXX XXX X X XXX XXX X X XXXXXXX X X XXXXXXX XXXXXXX X
X   X     X   X     X     X   X   X X   X   X X         X X X   X X X   X   X X     X X       X X     X   X   X     X X   X     X
X X X XXXXX X XXXXX XXXXXXX X X X X XXXXXXXXX XXXXX XXX X X XXX X X XXXXX XXX XXXXXXX XXXXXXX X XXXXX XXX XXXXXXXXX X XXX X XXX X
X X     X   X X   X   X     X   X X                 X     X X     X       X       X   X   X   X   X X         X     X   X   X   X
X XXXXXXX XXX X X XXX X XXXXXXXXX XXXXXXXXXXXXXXXXXXX XXXXX XXXXXXX XXXXXXX XXXXXXX XXX X XXXXXXX X XXXXXXXXX X XXXXXXX XXXXX XXX
X X X     X   X X X     X   X   X X         X       X   X   X     X X       X         X X       X X X         X X   X   X   X   X
X X X XXXXX XXX X XXXXXXXXX X X X XXX XXXXX X XXXXX XXXXX XXX XXX X XXXXX XXX XXXXXXXXX XXXXXXX X X X XXXXXXXXX X X X XXX X XXX X
X X X X       X X   X       X X X     X   X X   X X     X       X X     X     X   X   X   X     X X X   X       X X   X   X     X
X X X XXXXXXX X XXX XXX XXXXX X X XXXXX X XXXXX X XXXXX XXXXXXX X XXXXX XXXXX XXX X X X X X XXXXX X XXX XXXXXXX X XXX X XXXXXXXXX
X   X     X X X   X   X       X   X     X       X     X   X   X X   X   X   X     X X X X X X     X   X X     X X X   X         X
XXXXXXXXX X X XXX XXX X XXXXX XXXXX XXXXXXXXXXXXX XXX XXX X X X XXX XXX X X XXX XXX X XXX X X XXXXX XXX X XXX X X XXXXXXXXXXXXX X
X       X X X     X   X X   X X   X   X     X     X X   X   X X   X   X X X   X X   X     X   X X       X X     X   X         X X
X XXXXX X X XXXXXXX XXXXX X XXX X XXX X XXX X X XXX XXX XXXXX XXXXXXX X X XXX XXX XXXXXXXXXXXXX X XXXXXXX XXXXXXXXX X X X XXXXX X
X   X X X X   X   X   X   X     X     X   X   X   X   X     X X   X   X X X X   X X           X   X   X     X       X X X X   X X
XXX X X X X X X X XXX X XXXXXXXXX XXXXXXXXXXX XXX X X XXX XXX X X X XXX X X XXX X X XXX XXXXXXX XXX X XXX X XXX X XXX X X X X X X
X   X X X X X X X   X X   X   X   X         X   X X X     X   X X   X X   X   X   X   X X   X   X   X   X X   X X     X X X X X X
X XXX X X XXX X X XXX X X X X XXXXX XXXXXXX XXXXX X XXXXXXX XXX XXXXX XXXXX XXXXXXX X XXX X X XXX XXXXX XXX X XXX XXXXX X X X X X
X   X X X   X   X     X X   X X     X X   X     X X   X     X   X   X     X       X X     X X X   X   X   X X   X X     X X X   X
XXX X X X X XXXXX XXXXX XXXXX X XXXXX X X XXXXX X XXX X XXXXX XXX X X X X XXX X X XXXXXXXXX X X XXX X XXX XXX X X X XXXXX X XXXXX
X   X X X X X   X     X X   X X X       X     X X X   X X     X X X   X X   X X X         X X   X   X   X   X X X X   X   X X   X
X XXX X XXX X X XXXXX XXX X X X XXXXXXXXX XXX X X XXXXX X XXX X X XXXXX XXX XXX XXXXXXXXX X XXXXX XXX XXXXX X X X XXX X XXX X X X
X   X     X X X X   X   X X X X         X X   X X X     X X   X   X   X X       X       X X     X X   X     X X X   X X   X X X X
XXX XXXXX X X XXX X XXX X X X XXXXXXXXX X XXXXX X X XXXXXXX XXX XXX X X XXXXXXXXX XXXXXXX XXXXX X X XXX XXXXXXX XXXXX XXX X XXX X
X X   X     X   X X   X   X X     X       X     X X X       X   X   X X X     X           X     X X     X       X     X   X X   X
X XXX XXXXXXXXX X XXX XXXXX X XXX X XXXXXXX XXXXX X X XXX XXXXX X XXX X X XXX X XXXXXXXXXXX XXXXX XXXXXXXXX XXXXX XXXXX XXX X X X
X   X X         X X X     X X   X X   X   X X X   X X X   X   X X   X X   X X X         X   X     X         X   X   X X X X X X X
XXX X X XXXXXXXXX X XXXXX X XXX X XXX X X X X X X X XXX XXX X X XXXXX XXXXX X XXXXXXXXX X X X XXXXXXXXX XXXXX X X X X X X X X X X
X   X X X   X   X X X     X   X X     X X   X X X X     X   X X             X         X X X X   X       X     X   X X     X   X X
X X X X X X XXX X X X XXX XXX XXXXXXX X XXXXX X X XXXXXXX XXX XXXXXXXXXXXXX XXXXXXXXX X X XXXXX XXX XXXXX XXXXXXXXX XXXXXXXXXXX X
X X X X X X     X X X X     X   X   X X X X   X X           X   X       X X         X X X     X   X X   X     X   X X         X X
X X X X X XXXXXXX X X XXXXX XXX X X XXX X X X X XXXXXXXXXXX XXX X XXXXX X XXXXX XXXXX X XXXXX XXX X XXX XXXXX XXX X X XXXXX XXX X
X X X   X X       X X   X     X X X     X X X     X   X     X X X X     X       X   X X X     X   X X   X   X     X X X X   X   X
X XXXXXXX X XXXXXXX XXX XXXXXXX X XXXXXXX X XXXXXXX X X XXXXX X X XXXXX XXX XXXXX X X X X XXX X XXX X X X XXX XXXXX X X X XXX XXX
X X   X     X   X     X       X   X     X X   X     X X X   X X X X   X   X   X   X   X   X   X     X X   X   X     X   X X   X X
X X X X XXXXXXX X X X XXXXXXX XXXXX X X X XXX X XXXXX X X X X X X X X XXX XXXXX X XXXXXXXXX XXXXXXXXX XXXXX XXX XXXXX XXX X XXX X
X   X X       X   X X       X X     X X   X   X X   X X   X X X X X X   X       X X   X   X X     X       X X X       X   X   X X
XXXXX XXXXXXX X XXX XXXXXXXXX X XXXXX XXXXX XXX X X X XXXXX X X X X XXX XXX XXXXXXX X X X X X X XXX XXXXX X X XXXXXXXXX XXXXX X X
X       X     X X   X       X X     X         X   X X X     X X   X X X X   X       X X X   X X X   X   X X X     X   X       X X
X XXXXXXX XXXXXXX X X XXXXX X XXXXX XXXXXXXXXXXXXXX X X XXXXX XXX X X X XXXXX XXXXXXX X XXXXXXX X XXX X X X X XXX XXX XXXXXXXXX X
X   X     X X     X X X     X     X     X           X X X       X X   X         X     X         X X   X X X X   X   X           X
X X X XXXXX X X XXX X XXX XXXXXXX X XXXXX XXXXXXXXXXX X X X XXXXX XXX XXXXXXXXXXX XXXXXXXXXXXXX X X XXX X X XXX XXX X XXXXXXXXX X
X X   X   X X X X   X   X X     X   X   X X       X   X X X       X   X     X     X         X   X X X   X X   X X   X X       X X
X XXXXX X X X X XXXXXXX X X XXX X XXX X X X XXXXXXX XXX X XXXXXXXXX XXX X XXX XXXXXXXXX XXXXX XXX X XXXXX XXX X XXX XXX XXXXX X X
X       X X X X   X     X X X   X X X X   X       X   X X X       X X   X X   X         X       X X X   X     X   X     X     X X
XXXXXXXXX X X XXX X XXXXX X X XXX X X XXXXXXXXXXX XXX X X X X XXX X XXXXX X XXXXX XXXXX X XXXXXXX X X X XXXXXXX X XXXXXXX XXXXX X
X   X   X X X   X X   X   X X   X   X X             X   X X X X X X     X X     X     X X X       X   X     X   X X   X   X     X
X X X X X X XXX X XXX X XXX XXX XXXXX X XXX XXXXX XXXXXXX XXX X X XXXXX X XXXXX XXXXX X X X XXXXXXX XXX XXX X XXX XXX X XXX XXX X
X X   X X X X   X   X X     X X   X   X X   X     X     X     X X X   X X     X     X X X X     X X   X   X X X   X   X   X X   X
X XXXXXXX X X XXXXX X XXXXXXX XXX X XXXXX XXX XXXXX XXX XXXXXXX X XXX X XXXXX XXXXX X XXX XXXXX X XXX XXX X XXX XXX X XXX XXX X X
X         X     X   X   X X     X X X     X X X   X X X X     X       X   X       X X X   X     X     X   X X   X   X   X     X X
X XXXXXXXXX XXXXX X XXX X X X XXX X X XXXXX X X XXX X X X XXX X XXXXXXXXX X XXX XXX X X XXX XXXXX XXXXX XXX X XXX XXXXXXXXXXXXX X
X   X       X     X   X X   X   X X X X X       X   X X X   X   X         X X   X   X     X   X X   X X X X   X X               X
XXX XXXXXXXXX XXXXXXX X XXXXXXX X X X X X XXXXXXX XXX X XXX XXXXX XXXXXXXXX XXX X XXXXXXXXXXX X XXX X X X XXXXX X XXXXXXXXXXXXXXX
X   X     X   X     X X     X   X X X X   X           X   X     X X     X     X X       X     X   X   X X       X X       X     X
X XXX XXX X XXXXXXX X XXXXX X XXX X X XXXXX XXXXXXXXXXX X XXXXX X XXX X X XXX XXXXXXXXX X XXXXX XXXXX X X XXX XXX X XXXXX XXX XXX
X X   X   X X   X   X X   X X X   X X     X   X       X X   X   X   X X X   X         X X X         X X X   X X   X X   X   X   X
X X XXX XXX X X X XXX X XXX X X XXX XXXXX XXX X XXXXX XXXXX X XXXXX X X XXX XXXXXXX XXX X XXXXX X XXX X X X X X XXX X X XXX X X X
X X   X     X X X X   X   X X   X       X   X X X   X X   X X X   X X X   X   X   X   X X X   X X     X X X X X X   X X X   X X X
X XXX XXXXXXX X X X XXXXX X X XXXXX XXX X X X X X XXX X X X X X X X X XXX XXX XXX XXX X X X X X XXXXXXX XXX X X X XXX X X XXX X X
X   X X     X X X X X   X X X     X   X X X   X X   X   X X   X X   X   X         X   X X   X X X   X   X   X X   X X X   X X X X
XXX X X XXX X X X X X X X X XXXXX XXXXX XXX XXX XXX XXXXX XXX X XXXXXXXXXXXXXXXXX X XXX XXXXX X X XXX XXX XXX XXXXX X XXXXX X X X
X X X   X   X X X X   X   X     X     X   X X X   X   X X   X X   X     X       X X   X       X X X   X   X   X     X X X     X X
X X XXXXX XXX X X XXXXXXX XXXXX XXXXX XXX X X XXX X X X XXX XXXXX X XXX X XXXXX XXXXX XXXXXXXXX X X XXX XXXXX XXX XXX X X XXXXX X
X X   X   X   X X       X X   X   X       X   X     X     X     X X   X   X   X             X X X X X       X   X X   X   X   X X
X XXX X XXXXX X XXXXXXX X X X XXX XXXXXXXXXXX X XXXXXXXXXXXXX XXX X X XXXXX X XXXXXXXXXXXXX X X X X X XXXXX XXX X X XXXXXXX X X X
X     X     X X         X X X   X     X   X X X X             X   X X     X X   X   X     X X X   X X     X X     X   X     X   X
X XXXXXXXXX X XXXXXXXXXXX XXXXX XXXXX X X X X X X XXXXXXX XXXXX XXX XXXXX X X X X X X XXXXX X XXX X XXXXX X XXXXX XXX X XXXXXXXXX
X X         X         X   X         X   X X   X X X   X   X     X   X   X X X X X X X X     X     X     X X   X   X   X X       X
X X XXXXXXXXX XXXXXXX X XXX XXXXXXX XXXXX XXXXX X X X XXX X XXXXXXX X X X XXX X X X X X XXXXXXXXXXXXXXX X XXX X XXX XXX X XXXXX X
X X X X       X   X   X   X X     X X   X       X   X   X X X     X X X   X   X   X   X X               X X X X X   X   X X X   X
X X X X XXXXXXX X X X XXX X X XXX XXX X XXXXXXXXXXXXXXX X X X XXX XXX XXXXX XXXXXXXXX X X XXX XXXXXXXXXXX X X XXX XXX X X X X X X
X   X   X X     X   X X   X   X X X   X             X   X X X X   X   X   X       X   X X   X   X       X X X     X   X     X X X
XXXXX XXX X XXXXXXXXX X XXX XXX X X XXXXX X XXXXXXX X XXXXX X X XXX XXXXX X XXXXX XXXXX XXX XXX XXX X X X X XXXXXXX XXXXXXX X XXX
X     X   X       X   X X   X   X X X   X X X     X X     X X X   X X     X   X X   X   X     X   X X X X   X   X   X   X   X   X
X XXXXX X XXXXXXX XXXXX XXX X X X X XXX X XXX XXX XXXXXXX X X XXX X X XXXXXXX X XXX X XXX XXXXXXX X X X XXX X XXX XXX X XXX XXX X
X   X   X       X X   X   X   X X       X     X X     X   X   X X   X X     X X   X   X X   X     X X X   X X       X X   X X   X
XXX XXX XXXXXXX X X X XXX XXXXX XXXXXXXXX XXXXX XXXXX X XXXXXXX XXXXX X XXX X X XXXXXXX X XXX XXXXXXX XXX X X XXXXXXX XXX X X XXX
X X   X       X X   X     X   X X       X       X   X X             X   X X   X X         X   X     X X   X X   X X   X X X X   X
X XXX XXX XXXXX XXXXXXXXXXX XXX X XXXXX XXX XXXXX X X XXXXXXXXXXX X X XXX XXXXX X XXXXXXXXX XXXXX X X XXXXX XXX X X XXX X XXXXX X
X   X   X X   X     X     X     X X   X X X X     X     X       X X X X         X       X   X     X X X     X X   X X   X       X
X X XXX X X X X XXX X XXX X XXXXX X XXX X X X XXXXXXXXX X X XXXXX XXX XXXXXXXXX XXXXXXX X XXX XXXXX X X XXXXX X XXX X X XXXXXXX X
X X   X X X X X X   X   X   X   X X   X X   X       X X X X X   X   X         X       X X X       X   X X     X X   X X   X   X X
XXXXX X XXX X X X XXXXXXXXXXX X X XXX X X XXXXXXXXX X X X X X X XXX XXXXXXXXX XXX XXX X X XXXXXXX X XXX X XXX X X XXX X XXX X X X
X     X     X   X X       X   X   X   X X X     X X X   X X   X   X     X   X   X X   X X   X     X X   X   X X X   X X     X X X
X XXXXXXXXXXXXXXX XXX XXX X XXXXXXX XXX X X XXX X X X XXXXX XXXXX XXX X X XXXXX X X X X XXX X XXXXX X XXXXX X X XXX XXXXXXX X X X
X         X     X     X X   X       X   X X X X X X X X   X X     X X X   X     X X X X   X X X   X X     X X X X X   X   X X X X
X XXXXX XXX XXX XXXXXXX XXXXX X XXXXX XXX X X X X X X X X XXX XXX X X XXXXX XXXXXXX XXX XXX X X X X XXXXX X X X X XXX X X XXX X X
X X   X   X   X           X   X     X   X X X     X X X X     X     X X     X     X     X   X   X X     X X X       X X X   X   X
X X XXXXX XXX XXXXXXXXXXX X XXXXXXX XXX X X XXXXX X X X XXXXXXX XXXXX X XXXXXXX X X XXXXX XXX XXX XXXXX X XXXXXXXXXXX X XXX X XXX
X X X     X X X         X   X     X X   X X     X X X   X     X X X   X   X     X X   X   X X X X   X   X           X     X X   X
X X X XXX X X XXXXX XXX XXXXX XXX X X XXX XXXXX X X XXXXX XXXXX X X XXXXX XXX XXX X XXX XXX X X XXX XXXXXXXXXXXXXXX XXXXXXX XXX X
X X X X     X   X   X X X       X X   X     X   X X X     X     X X       X   X   X X   X   X X   X               X         X   X
X X X XXXXX XXX X XXX X X XXXXX X XXXXXXXXX X X XXX X XXX X XXXXX XXXXXXXXX XXX XXXXX XXX XXX X X XXXXXXXXXXXXXXX XXXXXXXXXXX XXX
X   X   X X   X X X     X   X   X X       X   X X   X X   X X       X X     X X     X   X   X X X     X X         X     X X   X X
XXX XXX X XXX X X X XXXXXXX X XXX X XXXXX XXXXX X XXX XXXXX XXX XXX X X X XXX XXXXX XXX X X X X X XXX X X X XXXXX XXX X X X XXX X
X   X   X   X X   X   X   X X X   X     X   X   X   X   X   X   X X X X X X       X     X X X X X   X   X X X   X     X   X   X X
X XXX XXX XXX XXXXXXX X X XXX X XXX XXX XXX XXX XXX X X X XXX XXX X X X X X XXXXX XXXXXXXXX X X XXX XXX X XXX X XXXXXXXXXXXXX X X
X   X X         X   X   X   X X   X   X   X   X   X X X X     X X   X X X X     X         X   X   X   X X     X         X     X X
XXX X X XXXXXXXXX X XXXXXXX X XXX XXXXXXX XXX XXXXX XXX XXXXXXX X XXX X X XXXXX XXX XXXXX X XXXXXXXXX XXXXXXXXXXXXXXXXX X XXXXX X
X X X X     X     X X       X   X     X   X X X     X           X   X   X   X     X   X   X         X X       X         X X     X
X X X XXXXXXX XXXXX X XXXXXXX X XXXXX X XXX X X XXXXX XXXXXXXXX XXX XXXXXXX XXXXXXX X X XXXXXXXXXXX X X XXXXX X XXXXXXX X X XXX X
X X X   X   X     X X X   X   X X   X X X       X     X       X X X         X     X X X         X   X   X     X     X   X   X   X
X X XXX X X XXX XXX X X X XXXXX X X X X XXXXXXXXX XXX XXXXX XXX X XXXXXXXXXXX XXX XXX XXXXXXXXX X XXXXXXX XXX XXXXX X XXXXXXX XXX
X   X X   X     X   X   X       X X X X   X     X X X X   X   X X       X     X X   X X       X X         X     X   X X     X   X
X XXX XXXXXXXXXXX X XXXXXXXXXXXXX XXX X X X XXX X X X X X XXX X XXXXX X X XXXXX XXX X X XXXXX X XXXXXXXXXXX XXXXX X XXX XXX XXX X
X X       X       X X X     X X     X X X   X   X   X   X   X         X   X       X   X X   X X   X     X   X     X X   X X     X
X XXX XXXXX XXXXXXX X X X X X X XXX X XXXXXXX XXXXXXXXX XXX XXXXXXXXXXXXXXX XXXXX XXXXXXX X X XXX X XXX XXXXX XXXXX X XXX XXXXXXX
X   X X   X X X     X   X X   X X X X       X         X X   X   X     X   X   X         X X     X X   X       X   X X X         X
XXX X X X X X X XXXXXXXXX XXXXX X X XXXXXXX X XXXXXXX X X XXX X XXX X X X X X XXXXXXXXX X XXXXXXX XXX XXXXXXXXXXX X X XXXXX XXX X
X X X X X X X   X         X   X X X     X X X     X   X X X   X   X X   X   X X   X   X X X     X     X         X   X       X X X
X X X X X X X XXX XXXXXXXXX X X X XXX X X X XXXXXXX XXXXX X XXXXX XXX XXXXXXX X X XXX X X X XXX XXXXX X XXXXXXX XXXXXXXXXXXXX X X
X   X X X   X   X     X   X X       X X   X         X     X X   X   X X     X X X   X     X X X       X     X   X       X     X X
X XXX X XXXXXXX XXXXX X X X XXXXXXX X X XXXXXXXXXXXXX XXX X X XXXXX X XXXXX X X XXX XXXXXXX X XXXXXXXXXXXXX X X X XXXXX X X X X X
X X   X       X       X X   X X   X X X X             X   X   X     X X     X   X X X     X X     X       X X X X X   X   X X X X
X XXX XXXXXXX XXXXXXX X XXXXX X X X X XXX XXXXXXXXX XXXXXXXXX X XXXXX X X XXXXX X X X XXX X XXXXX X X XXXXX X XXX X X XXXXX X X X
X     X   X   X X     X       X X X X   X X     X X       X   X   X     X X   X   X X   X X       X X   X   X X   X X X X   X X X
XXXXX XXX X XXX X XXXXXXXXXXX X X XXXXX X X X X X XXXXXXX X XXXXX X XXXXXXX X XXXXX XXX X XXX XXXXX XXX X XXX X XXX X X X XXXXX X
X   X   X X X     X X     X   X X       X X X X X     X X X X X   X X       X     X     X X   X   X X X   X X X X   X X X     X X
X X XXX X X XXXXX X X XXX X XXX X XXXXXXX XXX X X X X X X X X X XXXXX XXXXXXXXXXX X XXXXX X XXX X X X XXXXX X X X XXX X XXXXX X X
X X   X X X X   X   X   X X   X X X       X   X X X X X X X   X       X       X X X X   X     X X X   X     X   X X   X   X X   X
X XXXXX X X X X XXXXXXX X XXX X XXX XXXXXXX XXX XXX X X X XXX XXXXXXXXXXX XXX X X XXX X XXXXXXX X XXX X XXX XXXXX X XXX X X XXXXX
X         X   X         X     X             X       X   X                 X     X     X         X       X         X     X       K
XXXXXXXXXXXXXXXXXXXXXXXXXXXXXXXXXXXXXXXXXXXXXXXXXXXXXXXXXXXXXXXXXXXXXXXXXXXXXXXXXXXXXXXXXXXXXXXXXXXXXXXXXXXXXXXXXXXXXXXXXXXXXXXXX